1111111111111111111111111111111111111111111111111111111111111111
1000000000010000000000000000000000000000000000000000000000000001
1000000000010000000000000000000000000000000000000000000000000001
1000-00000010000000000000000000000000000000000000000000000000001
1000000000010000000000000000000000000000000000000000000000000001
1000000000010000000000000000000000000000000000000000000000000001
1000000000010000000000000000000000000000000000000000000000000001
1000000000010000000000000000000000000000000000000000000000000001
1000000000010000000000000000000000000000000000000000000000000001
1000000000010000000000000000000000000000#00000000000000000000001
1000000000010000000000000000000000000000000000000000000000000001
1000000000010000000000000000000000000000000000000000000000000001
1000000000010000000000000000000000000000000000000000000000000001
1000000000010000000000000000000000000000000000000000000000000001
1000000000010000000000000000000000000000000000000000000000000001
1000000000010000000000000000000000000000000000000000000000000001
1000000000010000000000000000000000000000000000000000000000000001
1000000000010000000000000000000000000000000000000000000000000001
1000000000010000000000000000000000000000000000000000000000000001
1000000000010000000000000000000000000000000000000000000000000001
1000000000010000000000000000000000000000000000000000000000000001
1000000000010000000000000000000000000000000000000000000000000001
1000000000010000000000000000000000000000000000000000000000000001
1000000000010000000000000000000000000000000000000000000000000001
1000000000010000000000000000000000000000000000000000000000000001
1000000000010000000000000000000000000000000000000000000000000001
1000000000010000000000000000000000000000000000000000000000000001
1000000000000000000000000000000000000000000000000000000000000001
1000000000000000000000000000000000000010000000000000000000000001
1000000000000000000000000000000000000010000000000000000000000001
1000000000000000000000000000000000000010000000000000000000000001
1000000000000000000000000000000000000010000000000000000000000001
1000000000000000000000000000000000000010000000000000000000000001
1000000000000000000000000000000000000010000000000000000000000001
1000000000000000000000000000000000000010000000000000000000000001
1000000000000000000000000000000000000010000000000000000000000001
1000000000000000000000000000000000000010000000000000000000000001
1000000000000000000000000000000000000010000000000000000000000001
1000000000000000000000000000000000000010000000000000000000000001
1000000000000000000000000000000000000010000000000000000000000001
1000000000000000000000000000000000000010000000000000000000000001
1000000000000000000000000000000000000010000000000000000000000001
1000000000000000000000000000000000000010000000000000000000000001
1000000000000000000000000000000000000010000000000000000000000001
1000000000000000000000000000000000000010000000000000000000000001
1000000000000000000000000000000000000010000000000000000000000001
1000000000000000000000000000000000000010000000000000000000000001
1111111111111111111111111111111111111111111111111111111111111111