1111111111111111111111111111111111111111111111111111111111111111
1000000000000000000100000000000000000000000000000000000000000001
1000000000000000000100000000000000000000000000000000000000000001
1000000000000000000100000000000000000000000000000000000000000001
1000000000000000000000000000000000000000000000000000000000000001
1000000000000000000000000000000000000000000000000000000000000001
1000000000000000000000000000000000000000000000000000000000000001
1000000000000000000100000000000000000000000000000000000000000001
1000000000000000000100000000000000000000#00000000000000000000001
1000000000000000000100000000000000000000000000000000000000000001
1000000000000000000100000000000000000000000000000000000000000001
1000000000000000000000000000000000000000000000000000000000000001
1000000000000000000000000000000000000000000000000000000000000001
1000000000000000000000000000000000000000000000000000000000000001
1000000000000000000000000000000000000000000000000000000000000001
1000000000000000000000000000000000000000000000000000000000000001
1000000000000000000000000000000000000000000000000000000000000001
1000000000000000000000000000000000000000000000000000000000000001
1000000000000000000000000000000000000000000000000000000000000001
1000000000000000000000000000000000000000000000000000000000000001
1000000000000000000000000000000000000000000000000000000000000001
1000000000000000000000000000000000000000000000000000000000000001
1000000000000000111111111111111111111111111111111111111111111111
1000000000000000100000000000000000000000000000000000000000000001
1000000000000000100000000000000000000000000000000000000000000001
1000000000000000100000000000000000000000000000000000000000000001
1000000000000000100000000000000000000000000000000000000000000001
1000000000000000100000000000000000000000000000000000000000000001
1000000000000000100000000000000000000000000000000000000000000001
1000000000000000100000000000000000000000010000000000000000000001
1000000000000000100000000000000000000000010000000000000000000001
1000000000000000100000000000000000000000010000000000000000000001
1000000000000000000000000000000000000000010000000000000000000001
1000000000000000000000000000000000000000010000000000000000000001
1000000000000000000000000000000000000000010000000000000000000001
1000000000000000000000000000000000000000010000000000000000000001
1000000000000000000000000000000000000000010000000000000000000001
1000000000000000000000000000000000000000010000000000000000000001
1111111111111111111111111000011111111111110000000000000000000001
1000000000000000000000000000000000000000010000000000000000000001
1000000000000000000000000000000000000000010000000000000000000001
1000000000000000000000000000000000000000010000000000000000000001
1000000000000000000000000000000000000000000000000000000000000001
10000+0000000000000000000000000000000000000000000000000000000001
1000000000000000000000000000000000000000000000000000000000000001
1000000000000000000000000000000000000000000000000000000000000001
1000000000000000000000000000000000000000000000000000000000000001
1111111111111111111111111111111111111111111111111111111111111111
