4100000000000000
1111111110000000
1111111111000000
1111111111100000
1111111000000000
1111111111100000
0000000011111115
