400000000000000000
110000000000000000
111000000000000000
101110000000000000
100111000000000000
100001100000000000
100000111000000000
100000011100000000
100000001111000000
100000000001110000
100000000000011100
111111111111111115
