4011101111111110111111111111111111101110111111111011111110111111111111101111111
1010101000100010000000001000000000101000001000001000001010100000001000101000001
1110111110111010111111111010111110101110111011101111111010101111111010101011101
0000000000001010100000000010100010100010100010101000000010001000000010101010101
1111111111101011101011111011101110111010101010111011101111111011111110101010101
1000000000101000001010101010001000001010101010000010100000000010001000100010101
1011111111101110111010101011101111101010101110101110111111101111101011101110111
1000000000101010001010100000100010101010101000101000000000100000101010001000001
1011111110101011101110101111101010101110101111101011111010111011101111111011101
1010000010101000100000101000001010100010100000001000101010001010000000000010101
1110111010101110111110101111111010101110111110111011101111101010111011101110111
0000101010100000000010100000001010001000000010100010000000001000101010101000000
1111101110101111111110111111101011101010111110101111101111111011101010101011111
1000000000101000000000100010001000101010100010101000101000000010001010001010001
1110101111101110111110101011101010111110111010101110101110111011101010111011101
0010101000001010101000101000101010000010001000100000100010101010001010100000101
1110111011111010101011101110111110111010111011111111111010101110111011111110101
1000100000000010101010001010000010101000100010000000000010100000100000000010001
1011111111111110101111111010111010101110101110101111111011111110101110111110111
1010000000000000100000000010101000100010101000101000001010000000101010100000101
1010111111111110101010111110101111101110101111101110101010101110101010101111101
1000100000000010101010000000100000001000100000100010101010100010101010100000101
1111101110111110111011111111101111101110111110111011101011111010111010101111101
1000001010100000001000000000001000000010100000001000101000100010000010101000001
1111101010111011101011111110111111111010111011111110101011101110111110101011101
0000001010001010001010000010100000100010101010000000101000001000100000101000101
1111111010111011111010111010111010111110101010101111101110111011101111101110101
1000000010101000001010001010001010000000101010101000000010100010100010000010101
1010111110101011101011101011101110101110101110101111101011101110111011111110111
1010100000101010100000101000100010101010100000100000101000001000001000000000100
1011101111101010101110111010101110111010101110111110111010111011101111101110101
1000100010100010101010001010101000000010101010000010001010100010100000100010101
1110111010101110101011101010101011111110111011111111101011101110101110111010111
1010001010101000101000101010101000100010000000000010001010001000100010001010001
1011101010101110111011101010101111101110111011111010111011111011111010111011101
1000101010000010000010101010100000001000101000001010100000000000001010100010101
1110101110111011111010101010101110111010101111111010101110111011101110101010111
0010100000101000001010001010101010100010100000000010101010101010100000101010000
1110111111101111111011111110111011111111111111111110111011101110111111101111511
