11111111111111111111
11100000000111111111
11101111110111111111
11011411110111111111
11101111110111111111
11100000000111111111
11111111111111111111
11111111111111111111
11111111111111111115
